#######################################/
#2221..............3..............1222#/
#2221..............3..............1222#/
#2221..............3..............1222#/
#2221..............3..............1222#/
#2221..............3..............1222#/
#2221..............3..............1222#/
#2221..............3..............1222#/
#2221..............3..............1222#/
#2221..............3..............1222#/
#2221..............3..............1222#/
#2221..............3..............1222#/
#2221..............3..............1222#/
#2221..............3..............1222#/
#2221..............3..............1222#/
#2221..............3..............1222#/
#2221..............3..............1222#/
#2221..............3..............1222#/
#2221..............3..............1222#/
#2221..............3..............1222#/
#2221..............3..............1222#/
#2221..............3..............1222#/
#2221..............3..............1222#/
#2221..............3..............1222#/
#2221..............3..............1222#/
#2221............X.3..............1222#/
#2221..............3..............1222#/
#2221..............3..............1222#/
#2221..............3..............1222#/
#######################################/

